###############
#A..#..#.#..#.#
#.#....##.#...#
##....##..#.#.#
#..........#..#
#.###..#..###.#
#...#####.#..##
##.....#...#..#
#...##..#..#.##
#.#.......#.###
#.......##..#.#
#.##...##..#.##
#.....#.......#
#..........#.E#
###############
